########################
#                      #
#         C       Y    #
#   H         K   Y    #
#                 Y    #
#                 Y    #
# XXXX                 #
#                      #
#    R     V      G    #
#    B               E #
#    P                 #
########################