########################
#                      #
#         C       Y-1H    #
#   H          K       #
#                      #
#                      #
#  X-2V                   #
#                      #
#          V       G   #
#    RB              E #
#    P                 #
########################