########################
#                      #
#         B            #
#                      #
#         BBB          #
#         R            #
#                      #
#                      #
#                      #
#                      #
#                      #
########################