########################
#                      #
#         C       Y-1H    #
#   H          K R     #
#                      #
#                      #
#  X-2V                   #
#                      #
#          V       G   #
#    B               E #
#    P                 #
########################