#####################
#      #     #  Y-3H   #
#   ## # C   #    K #
#   H#X-3V      #      #
# B  ####        ####
#         R      V  #
###X-3V      BB        #
#EG   #  ### PPP    #
###   #  #   PKP    #
#CP   #  C   PPP   C#
#####################