########################
#                      #
#         C       S    #
#   X         K   S    #
#                 S    #
#         R       S    #
# SSSS                 #
#                      #
#          X      G    #
#    P               E #
#    H                 #
########################