########################
#                      #
#         C       Y-1H    #
#   H          K       #
#                      #
#                      #
#  X-2V                   #
#                      #
#    R     V       G   #
#    B               E #
#    P                 #
########################