########################
#                      #
#         C       S    #
#   X         K   S    #
#                 S    #
#                 S    #
# SSSS                 #
#                      #
#    R     X      G    #
#    P               E #
#    H                 #
########################